,--.   ,--.                                            ,--.   ,--.   ,--.            ,--.   ,--.                  
,-'  '-. |  ,---.   ,---.  ,--,--,           ,--.   ,--. `--' ,-'  '-. |  ,---.      ,-'  '-. |  ,---.   ,---.      
'-.  .-' |  .-.  | | .-. : |      \          |  |.'.|  | ,--. '-.  .-' |  .-.  |     '-.  .-' |  .-.  | | .-. :     
  |  |   |  | |  | \   --. |  ||  | ,--.     |   .'.   | |  |   |  |   |  | |  |       |  |   |  | |  | \   --.     
  `--'   `--' `--'  `----' `--''--' '-,/     '--'   '--' `--'   `--'   `--' `--'       `--'   `--' `--'  `----'     
,--.                                        ,--.   ,--.                               ,---.                         
`--' ,--,--,  ,--.  ,--.  ,---.  ,--,--,  ,-'  '-. `--'  ,---.  ,--,--,       ,---.  /  .-'                         
,--. |      \  \  `'  /  | .-. : |      \ '-.  .-' ,--. | .-. | |      \     | .-. | |  `-,                         
|  | |  ||  |   \    /   \   --. |  ||  |   |  |   |  | ' '-' ' |  ||  |     ' '-' ' |  .-'                         
`--' `--''--'    `--'     `----' `--''--'   `--'   `--'  `---'  `--''--'      `---'  `--'                           
  ,--.   ,--.                                                                                                       
,-'  '-. |  ,---.   ,---.       ,---.  ,--,--. ,--,--,--.  ,---.  ,--.--.  ,--,--.          ,--.   ,--.  ,---.      
'-.  .-' |  .-.  | | .-. :     | .--' ' ,-.  | |        | | .-. : |  .--' ' ,-.  |          |  |.'.|  | | .-. :     
  |  |   |  | |  | \   --.     \ `--. \ '-'  | |  |  |  | \   --. |  |    \ '-'  | ,--.     |   .'.   | \   --.     
  `--'   `--' `--'  `----'      `---'  `--`--' `--`--`--'  `----' `--'     `--`--' '-,/     '--'   '--'  `----'     
,--.                                            ,--.                                                                
|  |-.   ,---.   ,---.   ,--,--. ,--,--,      ,-'  '-.  ,---.       ,---. ,--.--. ,--. ,--.                         
| .-. ' | .-. : | .-. | ' ,-.  | |      \     '-.  .-' | .-. |     | .--' |  .--'  \  '  /                          
| `-' | \   --. ' '-' ' \ '-'  | |  ||  |       |  |   ' '-' '     \ `--. |  |      \   '                           
 `---'   `----' .`-  /   `--`--' `--''--'       `--'    `---'       `---' `--'    .-'  /                            
                `---'                                                             `---'                             
