                     ,--.        ,--. ,--.                                                                            
 ,--,--. ,--,--,   ,-|  |      ,-|  | `--'  ,---.   ,--,--.  ,---.   ,---.   ,---.   ,--,--. ,--.--.  ,---.           
' ,-.  | |      \ ' .-. |     ' .-. | ,--. (  .-'  ' ,-.  | | .-. | | .-. | | .-. : ' ,-.  | |  .--' (  .-'           
\ '-'  | |  ||  | \ `-' |     \ `-' | |  | .-'  `) \ '-'  | | '-' ' | '-' ' \   --. \ '-'  | |  |    .-'  `) .--.     
 `--`--' `--''--'  `---'       `---'  `--' `----'   `--`--' |  |-'  |  |-'   `----'  `--`--' `--'    `----'  '--'     
,--.  ,--.                                                  `--'    `--'                                              
|  '--'  |  ,---.  ,--.--.  ,---.       ,--,--.     ,--.   ,--.  ,---.  ,--,--,--.  ,--,--. ,--,--,                   
|  .--.  | | .-. : |  .--' | .-. :     ' ,-.  |     |  |.'.|  | | .-. | |        | ' ,-.  | |      \                  
|  |  |  | \   --. |  |    \   --.     \ '-'  |     |   .'.   | ' '-' ' |  |  |  | \ '-'  | |  ||  |                  
`--'  `--'  `----' `--'     `----'      `--`--'     '--'   '--'  `---'  `--`--`--'  `--`--' `--''--'                  
                                                   ,--.                                                               
 ,---.  ,--.,--.  ,---.  ,---. ,--.,--. ,--,--,--. |  |-.   ,---.                                                     
(  .-'  |  ||  | | .--' | .--' |  ||  | |        | | .-. ' (  .-'                                                     
.-'  `) '  ''  ' \ `--. \ `--. '  ''  ' |  |  |  | | `-' | .-'  `)                                                    
`----'   `----'   `---'  `---'  `----'  `--`--`--'  `---'  `----'                                                     
                                                                   