╫▒░░░░░░░░░░░░░░░░░░░░░░░░░░░░░░░░░░░░░
╫▌░░░░░░░░░░░░░░░░░░░░░░░░░░░░░░░░░░░░░           
╢▌░░░░░▒▒▒▒▒▒▒▒▒▒░░░░░░░▒▒▒▒▒▒▒▒╫▒░░░░░                                    ▄▄▄▄█▓██▀▀▌                
╢▌░░░░░▒░░░░░░░▒▒░░░░░░░▒░░░░░░░╫▒░░░░░                          ▄▄▄▄▄▓▓██▀▀▀▀     ▄  ▐              
╠▒░░░░░▒░░──░░░▒▒░░░░░░░▒░░░─░░░╫▒░░░░░             ▄▄▄▄▓▓██▀▀▀▀              █▓█▀██▀▀██▓▓▄▄▄▄▓▓▓▓▓▄▄▄       
╠╣░░░░░▒░░──░░░▒▒░░░░░░░▒░░░─░░░╫▒░░░░░            █▐▀▀        ▄                ▌░░░▀░░░░░▒███▀███▓▓█▓▓█       
╠╣░░░░░▒░░──░░░▒▒░░░░░░░▒░░░─░░░╫▒░░░░░            ▐ █   ██▄ █▒█▀█              █▐▓▒▒███▒████▌             
╠╣░░░░░▒░░──░░░▒▒░░░░░░░▒░░░─░░░╫▒░░░░░            ▐▌▐  █▓▌ █ ▀█▄█        ▄▄▄ ▀▀█▐▓▒▒▒▒▒▒█████▀▀▀ ▄▄▄          
╠╣░░░░░▒░░──░░░▒▒░░░░░░░▒░░░─░░░╫▒░░░░░             ▌ █   ▀▀▀   ▄▄▄ ▀▀▀         ▀▀▀▀▀████▀▀▀▀█▄▄▄▄▄▄▄▄  ▀▀ ▄▄▄ 
╠╣░░░░░▒░░──░░░▒▒░░░░░░░▒░░░─░░░╫▒░░░░░             █ ▐▄▄▌▀▀▀  ▐▓███████▓▌                   ▀▀▀▀▀▀▀▀█▌▄▄▀▀▀  █
╠╣░░░░░▒░░──░░░▒▒░░░░░░░▒░░░─░░░╫▒░░░░░             █  ▌    ▀▀▀▄▄▄     ▄▓▓██████████▓▓▄    ▄▄▄ ▀▀▀      ▄▄▄▀██▌
╠╣░░░░░▒░░░░░░░▒▒░░░░░░░▒░░░░░░░╫▒░░░░░             ▐▀▀▀██▓▓▄▄▄▄     ▀▀▀▄▄▄▄    ▀▄▄▄▀▀▀▀     ▄▄▄▄█▓███▀▀▀▀▌   ▌
╠╣░░░░░▒▒▒▒▒▒▒▒▒▒░░░░░░░▒▒▒▒▒▒▒▒╫▒░░░░░             ▐▌        ▀▀▀▀██▓▓▄▄▄▄    █    ▄▄▄▄█▓███▀▀▀▀▄▄▄▄▀▀███▀▀   ▌
╢▌░░░░░░░░░░░░░░░░░░░░░░░░░░░░░░░░░▄▄▄░              ▌                  ▀▀▀▀██████▀▀▀▀▄▄▄▄▀▀▓███▀▀▀           ▌
╢▌░░░░░░░░░░      Pantry    ░░░░░░▐▒▒▒▓              ▌                      █ ▐   ████▀▀▀▀      ▄▄▄▄▓██▀▄     ▌
╫▌░░░░░░░░░░░░░░░░░░░░░░░░░░░░░░░░░╙▀▀░              █                      █ ▐▌      ▄▄▄▄▓▓██▒▒███████ █    ▐▌
╠▒░░░░░▒▒▒▒▒▒▒▒▒▒░░░░░░░▒▒▒▒▒▒▒▒▓▒░░░░░              ▐                      █  ▌    ███████████████████ █    ▐▌
╠╣░░░░░▒░░░░░░░▒▒░░░░░░░▒░░░░░░░╫▒░░░░░              ▐                      ▐  ▌    ███████████████████ █    ▐ 
╠╣░░░░░▒░░░──░░▒▒░░░░░░░▒░░──┌░░╫▒░░░░░              ▐▌                     ▐  ▌    ███████████████████ ▌    ▐ 
╠╣░░░░░▒░░░──░░▒▒░░░░░░░▒░░───░░╫▒░░░░░               ▌                     ▐  ▌    ▐██████████████████ ▌    ▐ 
╠╣░░░░░▒░░░──░░▒▒░░░░░░░▒░░───░░╫▒░░░░░               ▌                     ▐  █    ▐██████████████████ ▌    ▐ 
╠╣░░░░░▒░░░──░░▒▒░░░░░░░▒░░───░░╫▒░░░░░               █                     ▐▌ █    ▐████████████▓▓██▀▀▄     █ 
╠╣░░░░░▒░░░──░░▒▒░░░░░░░▒░░───░░╫▒░░░░░               █                      ▌ █    ▐████▓▓██▀▀██▄▀▀▀        █ 
╠╣░░░░░▒░░░░░░░▒▒░░░░░░░▒░░░░░░░╫▒░░░░░               ▐                      ▌ █     █▀██▄▀▀▀                █ 
╫▓╡░░░░▒▒▒▒▒▒▒▒▒▒░░░░░░░▒▒▒▒▒▒▒▒╫▒░░░░░                ▀ ▄▄                  ▌ ▐                         ▄▄▄▀▀ 
╢▌░░░░░░░░░░░░░░░░░░░░░░░░░░░░░░░░░░░░░                      ▀▀▄▄            ▌ ▐                 ▄▄▄▀▀▀        
╢▌░░░░░░░░░░░░░░░░░░░░░░░░░░░░░░░░░░░░░                            ▀▀▀▄▄     █ ▐         ▄▄▄▀▀▀                
╠▓░░░░░░░░░░░░░░░░░░░░░░░░░░░░░░░░░░░░░                                   ▀▀ █▄▐  ▄▄▀


