  ██▄                                            
  ████▄                                           
 ▐█████                                           
 ▐█████▌                                          
 ▐██████                                          
 ████▒▒▓                                          
 █▒▒▒▒▓▒▌                                ▄▄       
 ▒▓▓██▒▒▌         ▌  ▌                ▄██████▄    
 ▒████▒██        ▐▌  ▌  ▌ ▐▌        ▄██████████▄  
 ▒███████        ▐▌ ▐▌ ▐▌ ▐█       ▐███████████▓▄ 
 ▒██████▒        █▌ ▐▌ ▐▌ ▐▒      ▐███████▒▒▒███▓ 
 ▒██████▒        ▒▌ ▐▌ ▐▌ ▓▒      ██████▒▒▒▒▒▒▒▒█▌
 ▒██████▒        ▒▓ ██ ██ █▒      ▒████▒▒▒▒▒▒▒▒▒▒▒
 ▒██████▒        ▒▒▄▒▒▄▒▒▓▒▒      ▒███▒▒▒▒▒▒▒▒▒▒▒▒
 ▒█████▒▌        ▒▒▒▒▒▒▒▒▒▒▒      ▒███▓▒▒▒▒▒▒▒▒▒▒▒
 ▓▒███▒█         █▒▒▒▒▒▒▒▒▒▒      ▐▒█████▒▒▒▒▒▒▒█ 
 ▐▒▒█▒█           ▀▒▒▒▒▒▒▒▀         ▀█▒▒▒▒▒▒▒▒▀▀  
  █▒▒▒              ▀▒▒▒▀              ▀▒▒▒▀      
  ▐▒▒▌               ▒▒▒                ▒▒▒       
  ▐▒▒▌               ▒▒▒                ▒▒▒       
  ▐▒▒▌               ▒▒▒                ▒▒▒       
  ▒▒▒▌               ▒▒▒                ▒▒▒▌      
  ▒▒▒▌               ▒▒▒▌               ▒▒▒▌      
  ▒▒▒▒              ▐▒▒▒▌               ▒▒▒▒      
  ▒▒▒▒              ▐▒▒▒▌              ▐▒▒▒▒      
 ▐▒▒▒▒              ▓▒▒▒▒              ▒▒▒▒▒      
 ▓▒▒▒▒              ▒▒▒▒▒              ▒▒▒▒▒▌     
 ▒▒▒▒▒▌            ▐▒▒▒▒▒▌             ▒▒▒▒▒▌     
▐▒▒▒▒▒█            ▐▒▒▒▒▒▌            ▐▒▒▒▒▒▒     
▐▒▒▒▒▒▒            ▒▒▒▒▒▒▒            ▓▒▒▒▒▒▒     
█▒▒▒▒▒▒            ▒▒▒▒▒▒▒            ▒▒▒▒▒▒▒     
█▒▒▒▒▒▒▌           ▒▒▒▒▒▒▒            ▒▒▒▒▒▒▒     
▐▒▒▒▒██            █▒▒▒▒█▒            █▒▒▒▒██     
 ██████            ▐█████▌             ▒████▀     
   ▀▀                ▀▀▀                 ▀▀       

