    

     ╫▒░░░░░░░░░░░░░░░░░░░░░░░░░░░░░░░░░░░░░        ╫▒░░░░░░░░░░░░░░░░░░░░░░░░░░░░░░░░░░░░░
     ╫▌░░░░░░░░░░░░░░░░░░░░░░░░░░░░░░░░░░░░░        ╫▌░░░░░░░░░░░░░░░░░░░░░░░░░░░░░░░░░░░░░
     ╢▌░░░░░▒▒▒▒▒▒▒▒▒▒░░░░░░░▒▒▒▒▒▒▒▒╫▒░░░░░        ╢▌░░░░░▒▒▒▒▒▒▒▒▒▒░░░░░░░▒▒▒▒▒▒▒▒╫▒░░░░░
     ╢▌░░░░░▒░░░░░░░▒▒░░░░░░░▒░░░░░░░╫▒░░░░░        ╢▌░░░░░▒░░░░░░░▒▒░░░░░░░▒░░░░░░░╫▒░░░░░
     ╠▒░░░░░▒░░──░░░▒▒░░░░░░░▒░░░─░░░╫▒░░░░░        ╠▒░░░░░▒░░──░░░▒▒░░░░░░░▒░░░─░░░╫▒░░░░░
     ╠╣░░░░░▒░░──░░░▒▒░░░░░░░▒░░░─░░░╫▒░░░░░        ╠╣░░░░░▒░░──░░░▒▒░░░░░░░▒░░░─░░░╫▒░░░░░
     ╠╣░░░░░▒░░──░░░▒▒░░░░░░░▒░░░─░░░╫▒░░░░░        ╠╣░░░░░▒░░──░░░▒▒░░░░░░░▒░░░─░░░╫▒░░░░░
     ╠╣░░░░░▒░░──░░░▒▒░░░░░░░▒░░░─░░░╫▒░░░░░        ╠╣░░░░░▒░░──░░░▒▒░░░░░░░▒░░░─░░░╫▒░░░░░
     ╠╣░░░░░▒░░──░░░▒▒░░░░░░░▒░░░─░░░╫▒░░░░░        ╠╣░░░░░▒░░──░░░▒▒░░░░░░░▒░░░─░░░╫▒░░░░░
     ╠╣░░░░░▒░░──░░░▒▒░░░░░░░▒░░░─░░░╫▒░░░░░        ╠╣░░░░░▒░░──░░░▒▒░░░░░░░▒░░░─░░░╫▒░░░░░
     ╠╣░░░░░▒░░──░░░▒▒░░░░░░░▒░░░─░░░╫▒░░░░░        ╠╣░░░░░▒░░──░░░▒▒░░░░░░░▒░░░─░░░╫▒░░░░░
     ╠╣░░░░░▒░░░░░░░▒▒░░░░░░░▒░░░░░░░╫▒░░░░░        ╠╣░░░░░▒░░░░░░░▒▒░░░░░░░▒░░░░░░░╫▒░░░░░
     ╠╣░░░░░▒▒▒▒▒▒▒▒▒▒░░░░░░░▒▒▒▒▒▒▒▒╫▒░░░░░        ╠╣░░░░░▒▒▒▒▒▒▒▒▒▒░░░░░░░▒▒▒▒▒▒▒▒╫▒░░░░░
     ╢▌░░░░░░░░░░░░░░░░░░░░░░░░░░░░░░░░░▄▄▄░        ╢▌░░░░░░░░░░░░░░░░░░░░░░░░░░░░░░░░░▄▄▄░
     ╢▌░░░░░░░░░░     Bedroom    ░░░░░░▐▒▒▒▓        ╢▌░░░░░░░░░░   Family Room  ░░░░░░▐▒▒▒▓
     ╫▌░░░░░░░░░░░░░░░░░░░░░░░░░░░░░░░░░╙▀▀░        ╫▌░░░░░░░░░░░░░░░░░░░░░░░░░░░░░░░░░╙▀▀░
     ╠▒░░░░░▒▒▒▒▒▒▒▒▒▒░░░░░░░▒▒▒▒▒▒▒▒▓▒░░░░░        ╠▒░░░░░▒▒▒▒▒▒▒▒▒▒░░░░░░░▒▒▒▒▒▒▒▒▓▒░░░░░
     ╠╣░░░░░▒░░░░░░░▒▒░░░░░░░▒░░░░░░░╫▒░░░░░        ╠╣░░░░░▒░░░░░░░▒▒░░░░░░░▒░░░░░░░╫▒░░░░░
     ╠╣░░░░░▒░░░──░░▒▒░░░░░░░▒░░──┌░░╫▒░░░░░        ╠╣░░░░░▒░░░──░░▒▒░░░░░░░▒░░──┌░░╫▒░░░░░
     ╠╣░░░░░▒░░░──░░▒▒░░░░░░░▒░░───░░╫▒░░░░░        ╠╣░░░░░▒░░░──░░▒▒░░░░░░░▒░░───░░╫▒░░░░░
     ╠╣░░░░░▒░░░──░░▒▒░░░░░░░▒░░───░░╫▒░░░░░        ╠╣░░░░░▒░░░──░░▒▒░░░░░░░▒░░───░░╫▒░░░░░
     ╠╣░░░░░▒░░░──░░▒▒░░░░░░░▒░░───░░╫▒░░░░░        ╠╣░░░░░▒░░░──░░▒▒░░░░░░░▒░░───░░╫▒░░░░░
     ╠╣░░░░░▒░░░──░░▒▒░░░░░░░▒░░───░░╫▒░░░░░        ╠╣░░░░░▒░░░──░░▒▒░░░░░░░▒░░───░░╫▒░░░░░
     ╠╣░░░░░▒░░░░░░░▒▒░░░░░░░▒░░░░░░░╫▒░░░░░        ╠╣░░░░░▒░░░░░░░▒▒░░░░░░░▒░░░░░░░╫▒░░░░░
     ╫▓╡░░░░▒▒▒▒▒▒▒▒▒▒░░░░░░░▒▒▒▒▒▒▒▒╫▒░░░░░        ╫▓╡░░░░▒▒▒▒▒▒▒▒▒▒░░░░░░░▒▒▒▒▒▒▒▒╫▒░░░░░
     ╢▌░░░░░░░░░░░░░░░░░░░░░░░░░░░░░░░░░░░░░        ╢▌░░░░░░░░░░░░░░░░░░░░░░░░░░░░░░░░░░░░░
     ╢▌░░░░░░░░░░░░░░░░░░░░░░░░░░░░░░░░░░░░░        ╢▌░░░░░░░░░░░░░░░░░░░░░░░░░░░░░░░░░░░░░
     ╠▓░░░░░░░░░░░░░░░░░░░░░░░░░░░░░░░░░░░░░        ╠▓░░░░░░░░░░░░░░░░░░░░░░░░░░░░░░░░░░░░░

