                        ,--.                 ,--.                ,--.                                                            
,--.   ,--.  ,---.      |  |  ,--,--.  ,---. |  |,-.   ,---.   ,-|  |      ,--,--. ,--,--,                                       
|  |.'.|  | | .-. :     |  | ' ,-.  | | .--' |     /  | .-. : ' .-. |     ' ,-.  | |      \                                      
|   .'.   | \   --.     |  | \ '-'  | \ `--. |  \  \  \   --. \ `-' |     \ '-'  | |  ||  |                                      
'--'   '--'  `----'     `--'  `--`--'  `---' `--'`--'  `----'  `---'       `--`--' `--''--'                                      
            ,--.                                     ,--.                 ,--.   ,--.                                            
 ,--,--.  ,-|  |  ,---.   ,---.  ,--.,--.  ,--,--. ,-'  '-.  ,---.      ,-'  '-. |  ,---.   ,---.   ,---.  ,--.--. ,--. ,--.     
' ,-.  | ' .-. | | .-. : | .-. | |  ||  | ' ,-.  | '-.  .-' | .-. :     '-.  .-' |  .-.  | | .-. : | .-. | |  .--'  \  '  /      
\ '-'  | \ `-' | \   --. ' '-' | '  ''  ' \ '-'  |   |  |   \   --.       |  |   |  | |  | \   --. ' '-' ' |  |      \   '       
 `--`--'  `---'   `----'  `-|  |  `----'   `--`--'   `--'    `----'       `--'   `--' `--'  `----'  `---'  `--'    .-'  /        
         ,---.        ,--.  `--'          ,--. ,--.                                                                `---'         
 ,---.  /  .-'      ,-|  |  ,---.   ,---. |  | `--' ,--,--,   ,---.                                                              
| .-. | |  `-,     ' .-. | | .-. : | .--' |  | ,--. |      \ | .-. :                                                             
' '-' ' |  .-'     \ `-' | \   --. \ `--. |  | |  | |  ||  | \   --.                                                             
 `---'  `--'        `---'   `----'  `---' `--' `--' `--''--'  `----'  