,---.                              ,--.                           ,--.     ,--.                       ,--.                                 ,--.                     
/  .-'  ,---.  ,--.,--. ,--,--,   ,-|  |     ,--,--,--.  ,--,--. ,-'  '-. ,-'  '-.  ,---.  ,--.--.     `--' ,--,--,  ,--.  ,--.  ,--,--.  ,-|  |  ,---.   ,---.      
|  `-, | .-. | |  ||  | |      \ ' .-. |     |        | ' ,-.  | '-.  .-' '-.  .-' | .-. : |  .--'     ,--. |      \  \  `'  /  ' ,-.  | ' .-. | | .-. : (  .-'      
|  .-' ' '-' ' '  ''  ' |  ||  | \ `-' |     |  |  |  | \ '-'  |   |  |     |  |   \   --. |  |        |  | |  ||  |   \    /   \ '-'  | \ `-' | \   --. .-'  `)     
`--'    `---'   `----'  `--''--'  `---'      `--`--`--'  `--`--'   `--'     `--'    `----' `--'        `--' `--''--'    `--'     `--`--'  `---'   `----' `----'      
  ,--.   ,--.                             ,--.    ,--.    ,--. ,--.                ,--. ,--.           ,--.                                                          
,-'  '-. |  ,---.   ,---.      ,--,--,--. `--'  ,-|  |  ,-|  | |  |  ,---.       ,-|  | `--'  ,---.  ,-'  '-.  ,--,--. ,--,--,   ,---.  ,---.                        
'-.  .-' |  .-.  | | .-. :     |        | ,--. ' .-. | ' .-. | |  | | .-. :     ' .-. | ,--. (  .-'  '-.  .-' ' ,-.  | |      \ | .--' | .-. :                       
  |  |   |  | |  | \   --.     |  |  |  | |  | \ `-' | \ `-' | |  | \   --.     \ `-' | |  | .-'  `)   |  |   \ '-'  | |  ||  | \ `--. \   --.                       
  `--'   `--' `--'  `----'     `--`--`--' `--'  `---'   `---'  `--'  `----'      `---'  `--' `----'    `--'    `--`--' `--''--'  `---'  `----'                       
                                                                                                                                                                     