                                                                                                                                                         
  ,--.               ,--.                                                                                                                                
,-'  '-.  ,---.      |  ,---.   ,---.  ,--.--.      ,---.  ,--.   ,--. ,--,--,                                                                           
'-.  .-' | .-. |     |  .-.  | | .-. : |  .--'     | .-. | |  |.'.|  | |      \                                                                          
  |  |   ' '-' '     |  | |  | \   --. |  |        ' '-' ' |   .'.   | |  ||  |                                                                          
  `--'    `---'      `--' `--'  `----' `--'         `---'  '--'   '--' `--''--'                                                                          
 ,---.                                    ,--.   ,--.                           ,--.                            ,--.   ,--.                              
/  .-' ,--.--.  ,---.  ,--,--,   ,---.  ,-'  '-. `--'  ,---.      ,---.  ,---.  |  |  ,---.  ,--.--.  ,--,--. ,-'  '-. `--'  ,---.  ,--,--,              
|  `-, |  .--' | .-. : |      \ | .-. : '-.  .-' ,--. | .--'     | .--' | .-. | |  | | .-. | |  .--' ' ,-.  | '-.  .-' ,--. | .-. | |      \             
|  .-' |  |    \   --. |  ||  | \   --.   |  |   |  | \ `--.     \ `--. ' '-' ' |  | ' '-' ' |  |    \ '-'  |   |  |   |  | ' '-' ' |  ||  | .--.        
`--'   `--'     `----' `--''--'  `----'   `--'   `--'  `---'      `---'  `---'  `--'  `---'  `--'     `--`--'   `--'   `--'  `---'  `--''--' '--'        
,--------. ,--.                          ,--.          ,--.                   ,--.          ,--.                ,--.     ,--.                   ,--.     
'--.  .--' |  ,---.   ,---.       ,---.  `--'  ,---. ,-'  '-.  ,---.  ,--.--. `--'  ,--,--. |  |      ,--,--. ,-'  '-. ,-'  '-.  ,--,--.  ,---. |  |,-.  
   |  |    |  .-.  | | .-. :     | .-. | ,--. | .--' '-.  .-' | .-. | |  .--' ,--. ' ,-.  | |  |     ' ,-.  | '-.  .-' '-.  .-' ' ,-.  | | .--' |     /  
   |  |    |  | |  | \   --.     | '-' ' |  | \ `--.   |  |   ' '-' ' |  |    |  | \ '-'  | |  |     \ '-'  |   |  |     |  |   \ '-'  | \ `--. |  \  \  
   `--'    `--' `--'  `----'     |  |-'  `--'  `---'   `--'    `---'  `--'    `--'  `--`--' `--'      `--`--'   `--'     `--'    `--`--'  `---' `--'`--' 
                                 `--'                                                                                                                  