                                                                                                                                    
,--.  ,--.                                                                                                                          
|  '--'  |  ,---.  ,--.--.  ,---.       ,--,--.     ,--.   ,--.  ,---.  ,--,--,--.  ,--,--. ,--,--,                                 
|  .--.  | | .-. : |  .--' | .-. :     ' ,-.  |     |  |.'.|  | | .-. | |        | ' ,-.  | |      \                                
|  |  |  | \   --. |  |    \   --.     \ '-'  |     |   .'.   | ' '-' ' |  |  |  | \ '-'  | |  ||  |                                
`--'  `--'  `----' `--'     `----'      `--`--'     '--'   '--'  `---'  `--`--`--'  `--`--' `--''--'                                
                                                                ,---.                                  ,--.   ,--.                  
 ,---.  ,--,--,--.  ,---.  ,--.--.  ,---.   ,---.   ,---.      /  .-' ,--.--.  ,---.  ,--,--,--.     ,-'  '-. |  ,---.   ,---.      
| .-. : |        | | .-. : |  .--' | .-. | | .-. : (  .-'      |  `-, |  .--' | .-. | |        |     '-.  .-' |  .-.  | | .-. :     
\   --. |  |  |  | \   --. |  |    ' '-' ' \   --. .-'  `)     |  .-' |  |    ' '-' ' |  |  |  |       |  |   |  | |  | \   --.     
 `----' `--`--`--'  `----' `--'    .`-  /   `----' `----'      `--'   `--'     `---'  `--`--`--'       `--'   `--' `--'  `----'     
                          ,---.    `---'                            ,--.                                                            
 ,---.  ,--.,--. ,--.--. /  .-'  ,--,--.  ,---.  ,---.       ,---.  |  |  ,--,--. ,--,--,   ,---.                                   
(  .-'  |  ||  | |  .--' |  `-, ' ,-.  | | .--' | .-. :     | .-. | |  | ' ,-.  | |      \ | .-. :                                  
.-'  `) '  ''  ' |  |    |  .-' \ '-'  | \ `--. \   --.     | '-' ' |  | \ '-'  | |  ||  | \   --. ,--.                             
`----'   `----'  `--'    `--'    `--`--'  `---'  `----'     |  |-'  `--'  `--`--' `--''--'  `----' '-,/                             
,--.                     ,--.   ,--.                        `--'                                                                    
`--' ,--,--,  ,--.  ,--. `--' ,-'  '-.  ,---.   ,---.       ,---.  ,--.,--. ,--.--.      ,---.   ,--,--. ,-----.  ,---.             
,--. |      \  \  `'  /  ,--. '-.  .-' | .-. : (  .-'      | .-. | |  ||  | |  .--'     | .-. | ' ,-.  | `-.  /  | .-. :            
|  | |  ||  |   \    /   |  |   |  |   \   --. .-'  `)     ' '-' ' '  ''  ' |  |        ' '-' ' \ '-'  |  /  `-. \   --. ,--.       
`--' `--''--'    `--'    `--'   `--'    `----' `----'       `---'   `----'  `--'        .`-  /   `--`--' `-----'  `----' '-,/       
                                                                                        `---'                      