modified from https://www.asciiart.eu/buildings-and-places/furniture/beds

     _   ()
() .'_`'.||
||/.| ||\ |
| /|| || ||         _   ()
|| || || ||    () .'_`'.||
|| || || ||    ||/.| ||\ |
|| || |I-'`-._ | /|| || ||
||_I'`_.-||-._`'| || || ||
m._ <'_  ||   `|| || || ||
i| `-._`-'|    || || |I-'|
c) || ||`-.`-._||_I'`_.-||
||/.| ||\||`-._` _.-'   ()
| /|| || ||    ||       ()
|| || || ||    () .'_`'.||
|| || || ||    ||/.| ||\ |
|| || |I-'`-._ | /|| || ||
||_I'`_.-||-._`'| || || ||
m._ <'_  ||   `|| || || ||
i| `-._`-'|    || || |I-'|
c)     `-._`-._||_I'`_.-||
           `-._` _.-'   ()
               ||       `
               ()