                                                                                                           
                     ,--.               ,---.  ,---.                  ,--.              ,--.                  
 ,--,--. ,--,--,   ,-|  |      ,--,--. /  .-' /  .-'  ,---.   ,---. ,-'  '-.  ,---.   ,-|  |                  
' ,-.  | |      \ ' .-. |     ' ,-.  | |  `-, |  `-, | .-. : | .--' '-.  .-' | .-. : ' .-. |                  
\ '-'  | |  ||  | \ `-' |     \ '-'  | |  .-' |  .-' \   --. \ `--.   |  |   \   --. \ `-' |                  
 `--`--' `--''--'  `---'       `--`--' `--'   `--'    `----'  `---'   `--'    `----'  `---'                   
                ,--.         ,--.   ,--.                     ,--.             ,--.                            
 ,---.   ,---.  `--' ,--.--. `--' ,-'  '-. ,--.,--.  ,--,--. |  |      ,---.  |  |  ,---.   ,---.  ,--,--,--. 
(  .-'  | .-. | ,--. |  .--' ,--. '-.  .-' |  ||  | ' ,-.  | |  |     | .-. | |  | | .-. | | .-. | |        | 
.-'  `) | '-' ' |  | |  |    |  |   |  |   '  ''  ' \ '-'  | |  |     ' '-' ' |  | ' '-' ' ' '-' ' |  |  |  | 
`----'  |  |-'  `--' `--'    `--'   `--'    `----'   `--`--' `--'     .`-  /  `--'  `---'   `---'  `--`--`--' 
        `--'                                                          `---'                                   