                                                                                                                               
            ,--.   ,--.   ,--.                         ,--.                    ,--.             ,--.                    ,--.   
,--.   ,--. `--' ,-'  '-. |  ,---.       ,--,--.     ,-'  '-. ,--.,--. ,--.--. |  |-.  ,--.,--. |  |  ,---.  ,--,--,  ,-'  '-. 
|  |.'.|  | ,--. '-.  .-' |  .-.  |     ' ,-.  |     '-.  .-' |  ||  | |  .--' | .-. ' |  ||  | |  | | .-. : |      \ '-.  .-' 
|   .'.   | |  |   |  |   |  | |  |     \ '-'  |       |  |   '  ''  ' |  |    | `-' | '  ''  ' |  | \   --. |  ||  |   |  |   
'--'   '--' `--'   `--'   `--' `--'      `--`--'       `--'    `----'  `--'     `---'   `----'  `--'  `----' `--''--'   `--'   
                                                   ,--.                                    ,--.                                
     ,---. ,--.--.  ,---.   ,---.   ,---.  ,-----. |  |  ,--,--. ,--. ,--.  ,---.  ,--.--. `--' ,--,--,   ,---.                
    | .--' |  .--' | .-. | (  .-'  (  .-'  '-----' |  | ' ,-.  |  \  '  /  | .-. : |  .--' ,--. |      \ | .-. |               
    \ `--. |  |    ' '-' ' .-'  `) .-'  `)         |  | \ '-'  |   \   '   \   --. |  |    |  | |  ||  | ' '-' '               
     `---' `--'     `---'  `----'  `----'          `--'  `--`--' .-'  /     `----' `--'    `--' `--''--' .`-  /                
         ,---.     ,--.                             ,--.         `---'                    ,--.           `---'                 
 ,---.  /  .-'     |  |-.  ,--.--. ,--.,--.  ,---.  |  ,---.  ,--.   ,--.  ,---.  ,--.--. |  |,-.                              
| .-. | |  `-,     | .-. ' |  .--' |  ||  | (  .-'  |  .-.  | |  |.'.|  | | .-. | |  .--' |     /                              
' '-' ' |  .-'     | `-' | |  |    '  ''  ' .-'  `) |  | |  | |   .'.   | ' '-' ' |  |    |  \  \  .--.                        
 `---'  `--'        `---'  `--'     `----'  `----'  `--' `--' '--'   '--'  `---'  `--'    `--'`--' '--'                        
                                                                                                                               