                                                                                                                       
                    ,--.       ,--.                                        ,---.   ,--.                                    
,--. ,--.  ,---.  ,-'  '-.     |  |  ,---.  ,--,--,   ,---.       ,--,--. /  .-' ,-'  '-.  ,---.  ,--.--.                  
 \  '  /  | .-. : '-.  .-'     |  | | .-. | |      \ | .-. |     ' ,-.  | |  `-, '-.  .-' | .-. : |  .--'                  
  \   '   \   --.   |  |       |  | ' '-' ' |  ||  | ' '-' '     \ '-'  | |  .-'   |  |   \   --. |  |                     
.-'  /     `----'   `--'       `--'  `---'  `--''--' .`-  /       `--`--' `--'     `--'    `----' `--'                     
`---'                                                `---'                                                                 
                                                         ,--.   ,--.                        ,--.                           
 ,---.   ,---.  ,--.--.  ,---.   ,---.   ,---.   ,---. ,-'  '-. `--' ,--.  ,--.  ,---.      |  ,---.   ,--,--.  ,---.      
| .-. | | .-. : |  .--' (  .-'  | .-. | | .-. : | .--' '-.  .-' ,--.  \  `'  /  | .-. :     |  .-.  | ' ,-.  | (  .-'      
| '-' ' \   --. |  |    .-'  `) | '-' ' \   --. \ `--.   |  |   |  |   \    /   \   --.     |  | |  | \ '-'  | .-'  `)     
|  |-'   `----' `--'    `----'  |  |-'   `----'  `---'   `--'   `--'    `--'     `----'     `--' `--'  `--`--' `----'      
`--'                            `--'                                                                                       
        ,--.         ,--.    ,--. ,--.  ,---. ,--.            ,--.                                                         
,--.--. `--'  ,---.  `--'  ,-|  | `--' /  .-' `--'  ,---.   ,-|  |                                                         
|  .--' ,--. | .-. | ,--. ' .-. | ,--. |  `-, ,--. | .-. : ' .-. |                                                         
|  |    |  | ' '-' ' |  | \ `-' | |  | |  .-' |  | \   --. \ `-' |                                                         
`--'    `--' .`-  /  `--'  `---'  `--' `--'   `--'  `----'  `---'                                                          
             `---'                                                             