,--------. ,--.                           ,--.            ,--. ,--.   ,--.   ,--.                               ,---.     
'--.  .--' |  ,---.   ,---.       ,--,--. |  |-.   ,---.  |  | `--' ,-'  '-. `--'  ,---.  ,--,--,       ,---.  /  .-'     
   |  |    |  .-.  | | .-. :     ' ,-.  | | .-. ' | .-. | |  | ,--. '-.  .-' ,--. | .-. | |      \     | .-. | |  `-,     
   |  |    |  | |  | \   --.     \ '-'  | | `-' | ' '-' ' |  | |  |   |  |   |  | ' '-' ' |  ||  |     ' '-' ' |  .-'     
   `--'    `--' `--'  `----'      `--`--'  `---'   `---'  `--' `--'   `--'   `--'  `---'  `--''--'      `---'  `--'       
                                                         ,--.   ,--.                                                      
 ,---.   ,---.  ,--.--.  ,---.   ,---.   ,---.   ,---. ,-'  '-. `--' ,--.  ,--.  ,---.                                    
| .-. | | .-. : |  .--' (  .-'  | .-. | | .-. : | .--' '-.  .-' ,--.  \  `'  /  | .-. :                                   
| '-' ' \   --. |  |    .-'  `) | '-' ' \   --. \ `--.   |  |   |  |   \    /   \   --.                                   
|  |-'   `----' `--'    `----'  |  |-'   `----'  `---'   `--'   `--'    `--'     `----'                                   
`--'                            `--'                                                                                      
,--.                                   ,--.                                                 ,--.   ,--.                   
`--'  ,---.       ,--,--. ,--,--,      `--' ,--,--,  ,--,--,   ,---.  ,--.  ,--.  ,--,--. ,-'  '-. `--'  ,---.  ,--,--,   
,--. (  .-'      ' ,-.  | |      \     ,--. |      \ |      \ | .-. |  \  `'  /  ' ,-.  | '-.  .-' ,--. | .-. | |      \  
|  | .-'  `)     \ '-'  | |  ||  |     |  | |  ||  | |  ||  | ' '-' '   \    /   \ '-'  |   |  |   |  | ' '-' ' |  ||  |  
`--' `----'       `--`--' `--''--'     `--' `--''--' `--''--'  `---'     `--'     `--`--'   `--'   `--'  `---'  `--''--'  
    ,--.                                                                       ,--.   ,--.                                
    `--' ,--,--,       ,---.   ,---.  ,--.--.  ,---.   ,---.   ,---.   ,---. ,-'  '-. `--' ,--.  ,--.  ,---.              
    ,--. |      \     | .-. | | .-. : |  .--' (  .-'  | .-. | | .-. : | .--' '-.  .-' ,--.  \  `'  /  | .-. :             
    |  | |  ||  |     | '-' ' \   --. |  |    .-'  `) | '-' ' \   --. \ `--.   |  |   |  |   \    /   \   --.             
    `--' `--''--'     |  |-'   `----' `--'    `----'  |  |-'   `----'  `---'   `--'   `--'    `--'     `----'             
                      `--'                            `--'                                                                

