                                                      ░        ░░░░░                                                       
                                             ░▒▒▒░░▒░░░░▒▒░░░▒▒▒▒░▒▒▒▒▒▒▒▒▄▄▄                                                
                                          ░▒▒░▒▒▒▒▒▒▒▒▒▒▒▒▒▒▒▒▒▒▒▒▒▒▒▒▒▒▒▒░░░░░▒▒▒▄                                          
                                       ░▒▒▒░▒▒▒▒▒▒▒▒▒▒▒▒▒██▒▒▒▒▒▒▒▒▒▒▒▒▒▒▒▒░░░▒▒░░░░▒▒░░                                     
                                    ░░▒▒░░▒▒▒▒▒▒▒░▒▒▒▒▒▓▒▒▒▓█▓▒▒▒▒▒▒▒░░░░░░▒▒▒▒▒▒░▒▒▒▒░░░▒░                                  
                                   ░▒▒░▒▒▒▒▒▒▒▒▒▒▒▒▒▒█▒▒▒▒▒█▓███▒▒▒▒▒▒▒▒░░░░░░▒▒▒▒▒▒▒▒▒▒▒░▒▒░░░                              
                                 ▒▒░░░▒▒▒▒▒▒░▒▒▒▒▒▒▒▒▒▒▒▒▒▒▒██▒▒▒▒▒░░░░░░░░░░░░░░░▒▒▒▒▒▒▒▒▒▒▒▒░░░░                           
                               ▄▒░▒▒▒▒▒▒▒▒░▒▒▒▒▒░▒▒▒▒▒▒▒▒▒▒▒▒▒▒▓▒▒▓▒▒▒▒░░░░░░░░░░░░░▒▒▒▒▒▒▒▒▒▒▒▒▒░░                          
                              ░▒▒▒░░▒▒▒▒░▒▒▒▒▒░▒▒▒▒▒▒▒▒▒▒▒▒▒▒▒▒▒▒▒▒▒▒▒▒░░▒▒░░░░░░░░░░░░▒▒▒▒█▒▒▒▒▒▒░░                         
                             ░▒▒▒░░░▒▒░░▒▒▒▒▒▒▒▒▒▒▒▒░▒▒▒▒▒▒▒▒▒▒▒▓▒▓▓▒▒▒▒▄░░░░░░░░░░░░░░░░▒▒▒▒█▒▒▒▒▒▒░                        
                            ░▒░░░░░░▒░░▒▒▒▒░▒▒▒▒▒▒▒▒▒▒▒▒▒▒▒▒▒▒▒▒▒▒▒▒██▓▓▓▓▒▒▒░░░░░░░▒▒░░░░▒░▒▒▒▓▓▒▒▒▒▒                       
                           ░░░░░░░░░░▒▒▒░░▒▒▒▒▒▒▒▒▒▒▒▒▒▒▒▒▒░░▒▒▒▒▒▒▒▒▒▒▒██▓█▓▓▓▒▒░░░░░▒▒▒▒░░░░▒▒▒▒▓▒▒▒▒░                     
                          ░░░░░░░░░░▒▒▒░░▒▒▒▒▒▒▒▒▒▒▒▒▒▒▒▒░░░░░░░░▒▒▒▒▒▒▒▒▒▒▒███▓▓▒▒▒▒░░░▒▒▒▒▒░▒░▒▒▒▒▒▒▒▒░                    
                          ░░░░░░░░░▒▒▒▒▒▒▒▒▒▒▒▒▒▒▒▒▒▒▒▒░░░░░  ░   ░░ ░░░▒▒▒▒▒▒▒▒▒██▓▒▒▒▒░▒▒▒▒▒▒▒▒▒▒▒▒▒▒▒▒▒                   
                         ░░░░░░░░░░░▒▒▒▒▒▒▒▒▒▒▒▒▒▒▒▒▒▒░░░░░░░░         ░░░░░▒▒▒▒▒▒▒▒█▓▓▒▒▒▒▒▒▒▒▒▒▒▒▒▒▒▒▒▒▒▒                  
                         ░░░░░░░░░▒▒▒▒▒▒▒▒▒▒▒▒▒▒▒▒▒▒▒░░░░░░░░            ░░░░░░▒▒▒▒▒▒▒██▒▒▒▒▒▒▒▒▒▒▒▒▒▒▒▒▒▒▒▒                 
                        ░░░░░░░░░▒▒▒▒▒▒▒▒▒▒▒▒▒▒▒▒▒▒▒░░░░░░░░░             ░░   ░░▒▒▒▒▒▒▒█▓▒▒▒▒▒▒▒▒▒▒▒▒▒▒▒▒▒▒░                
                       ░░░░░░░░░▒▒▒▒▒▒▒▒▒▒▒▒▒▒▒▒▒▒▒▒░░░░░░░░░░                 ░░░░░░▒▒▒▒▒█▓▒▒▒▒▒▒▒▒▒▒▒▒▒▒▒▒▒░░              
                      ░░░░░░░░▒▒▒▒█▒▒▒▒▒▒▒▒▓▒▒▒▒▒▒░░░░░░░░░░░░                  ░░░░░░░░░▒▒▒▒▓▒▒▓▒▒▓▒▒▓▒▒▒▒▒▒▒░░             
                     ░░░░░░░░░▒▒▒█▒▒▒▒▒▓▓███▒▒▒░▒░░░░░░░░░░░░░░░  ░  ░░ ░░░░░░░░░░░░░░░░░░░░▒▒▒▒▒▒▓▒▒▓▒▒▒▒▒▒▒▒▒░░            
                      ░▒░░░░░▒▒▒▒▒▒▒▓▓█████▒▒▒▒░░░░░░░░░░░░░░░░  ░░░░░░░░░░░░░░░░░░░░░░░▒░░░▒▒▒░░▒▒▒▓▒█▓▒▒▒▒▒▒▒▒░░           
                    ░░▒▒░▒░░░▒▒▒▓▓████████▒▒▒▒▒░░░░░░░▒▒▒▒▒▒▒▒▒▒▄▒░░░░░░░░░░░░░░▒░░▒▒▒▒▒▓▓▒▒▒▒▒▒▒▒▒█▓█▓██▒▓▒▒▒▒▒▒░           
                     ░▒▒░▒▒░▒▒▒████████████▒▒▒▒░▒▒▒▒▒▒▒░░░▒▒▒▒▒▒▒▓▒▒▒▒▒▒▒▒▒▒▒▒▒▒▒▒▒▒▒██▒▒▒▒▒▒▒▒░░▒▒▒███▓▒█▒▒▒▒▒▒▒▒░          
                    ▐▒░░▒▒▒░▒▒▒████████████▒▒▒▒▒▒▒▒▒░░░░░░▄▒▒▒▒▒▒▒▒▒▒▒▒▒▒▒▒▒▒▒▒▒▒▒▒▒▒▒▒▓▓▓▓█▓▓▓▒▒▒▒▒▒████▓▓▓▓▓█▓▒▒▒          
                    ░░▒▒▒▒▒▒▒▒████████████▒▒▒▒▒▒▒▒▒▒▒▒▒▓██▒██████▓▒▒▒▒▒▒▒░░░░▒▒▒▒▒▒▒▒▒▒░░▒██████▓▒▒▒▒██▒████████▓▒▒▒        ▒
                    ░▒░▒▒▒▒▒▒▒███████████▒▒▒▒▒▒▒▒▒▒▒▒██▒▒▒█████▒▒▓▒▒▒▒▒░░░░  ░░▒▒▒▒▒▒▒▒▒▐▀▀▀█▒▒█▒▒▒▒▒▒▒█▒▒▒██████▓▒▒       ▒▒
                  ░ ░░▒▒▒▒▒▒▒▒███████████▒▒▒▒▒▒▒▒▒▒▒▒▒▒▒▒▒▒▒▒▒▒▒▒▒░░░░▒░░░░░  ░░░░░░░░░░░░░░▒▒▒▒░░░░▒▒▒██▓▒▒██████▒▒      ▐▒ 
                   ░░▒▒▒▒▒▒▒▒▒▒██████████▒▒▒▒▒▒▒░░░░░░░░░░░▒▒▒▒▒▒▒░░░░░░░░░░  ░░░░░░░░░░░░░░░░░░░░░░░░▒███▒▒▒▒████▓▒      ▒░ 
                   ░▒▒▒░▒▒▒▒▒▓▒█▒▒▒▒▓███▒▒▒▒▒▒░░░░░░░░              ░░░░░░░░   ░░░░░             ░░░░░░█▒████▒▓▒███▒     ▒▒  
                   ░▒▒▒░▒▒▒▒▒▒▒▒▓██████▒▒▒▒▒▒▒▒░░░░░░░░         ░░░ ░░░░░░░░   ░░░░░░          ░░░░░░▒▒▒█████▒▒███▒▒    ▐▒▒▒▒
                   ░▒▒▒░▒▒▒▒▒██████████▒▒▒▒▒▒▒▒▒▒▒▒░░░░░      ░░░░ ░░░░▒▒░░░░   ░░░░░░    ░   ░░░░░░▒▒▒▒██████▒████▒   ▐▒    
                   ░▒▒▒▒▒▒▒▒▒▒▒▒██▒▒██▒▒▒▒▒▒▒▒▒▒▒▒▒▒░░░░░░   ░░░░░░▒░░░░░░░░░    ░░░░▒░░░░  ░░░░░░░░░▒▒▒█████▒▒████▒   ▒▒    
                   ░▒▒▒▒▒▒▒▒▒▒▒▒▒▒▒▒▒▒█▒▒▒▒▒▒▒▒▒▒▒▒░░░░░░░░░░░░░░▒▒▒░░░░░▒▒░░░░░░░▒▒▒▒▒▒▒░░░░░░░░░░░▒▒▒▒▒█▒██▒▒▒█▒▌░  ▒▒     
                   ░▒▒▒▒▒▒▒▒▒▒▒▒▒▒▒▒▒▒▒▒▒▒▒▒▒▒▒▒▒▒▒░░░░░░░░░░░░▒▒▒░▒▒▒▒▒▓▓▒▒▒▒▒▒▒▒▒▓▓▒░░▒▒▒▒▒░▒▒▒▒▒▒▒▒▒▒▒▒▒▒▒▒▒▒█▒▒  ▐▒      
                   ░▒▒▒▒▒▒▒▒▒▒▒▒▒▒▒▒▓▒▒▒▒▒▒▒▒▒▒▒▒▒▒▒▒▒▒▒▒▒▒▒▒▒▒▒▒░░░▒▒▒▒▒▒▒▒█▓▓▒▓█▒▒▒▒░░▒▒▒▒▒▒▒▒▒▒▒▒▒▒▒▒█▒▒▒▒▒▒▒▒▒░ ▐▒       
                   ░▒▒▒▒▒▒▒▒▓▒▒▒▒▒▒▒▒▒▒▒▒▒▒▒▒▒▒▒▒▒▒▒▒▒▒▒▒▒▒▒▒▒▒▒░░░░░░░░▒▒▒▒▒▒▒▒▒▒▒▒▒░░░░▒▒▒▒▒▒▒▒▒▒▒▒▒▒▒▒▒▒▒▒▒▒▒▒░  █▒       
                    ▒▒▒▒▒▒▒▒█▓▒▒▒▒▒▒▒░▒▒▒▒▒▒▒▒▒▒▒▒▒▒▒▒▒▒▒▒▒▒▒▒▒░░░░░░░░░░░░▒▒▒▒▒▒▒▒▒░░▒░░▒▒▒▒▒▒▒▒▒▒▒▒▒▒▒▒▒▒░▒▒▒▒▓▓▓█▒▒▒▒▒▒   
                    ▒▒▒▒▒▒▒▒██▓▒▒▒▒▒▒░░░▒▒▒▒▒▒▒▒▒▒▒▒▒▒▒▒▒▒▒▒▒░▒▒▒░░▒▒▒▄▄▄▒▒▒▒▒▒▒▒▒▒▒▒▒▒▒▒▒▒▒▒▒▒░░▒▒▒▒▒▒▒▒▒░▒▒▒░░             
                    ░▒▒▒▒▒▒▒▒█▒█▒▒▒▒░░░░░▒▒▒▒▒▒▒▒▒░░▒▒░░▒▒▒▒▒▒▒▓▓▓▓▓██▓▓▓▓▒▒▒▒▒▀▒▒▒█████▒▒▒▒░░░░░▒░▒▒▒▒▒▒▒▒▒▒▒░░             
                    ░▒▒▒▒▒▒▒▒▒▒▒▒▒▒▒▒▒▒▒▒▒▒▒▒▒▒▒▒▒▒▒░▒░░░░░░░░░▒▒▒▒▒▒▒▒▒░░▒▒▒▒▒▒▒▒▒▒▒▒▒▒▒▒░░░░░░▒▒▒▒▒▒▒▒▒▒▒▒░░░░             
                    ░░▒▒▒▒▒▒▒▒▒▒█▓▒▒▒▒▒▒▒▒▓▓▒▒▒▒▒▒▒▒▒░▒░░░░░░░░░░░▒▒▒▒▒▒▒▒▒▄▒▒▒▒▒▒▒▒▒▒▒▒░░░░░░░░▒▒▒▒▒▒▒▒▒▒▒░░░░░             
                    ░░░▒▒▒▒▒▒▒▒▒▓▒▒▒▒▒▓██████▓▒▒▒▒▒▒▒▒▒▒░░░░░░░░░░░░▒▒▒▒▒▒▒▒▒▒▒▒▒▒▒▒▒▒▒░░░░░░░░░▒▒▒▒▒▒▒▒▒▒▒░░░░              
                    ░░░░▒▒▒▒▒▒▒▓▓▓██▓██████████▓▓▒▒▒▒▒▒░▒▒░░░░░░░░░░░░░░░░░▒░░░░░░░░░░░░░░░░░░▒▒▒▒▒▒▒▒▒▒▒▒▒▒░▄▄▄▄▄▄▄▄▄▄▄▄▄▄▄▄
                    ░░░░░▒▒▒▒▒▒██████████████████▓▓▒▒▒▒▒▒░░░░░░░░░░░░░░░░░░░   ░ ░░░░░░░░░░░░▒▒▒▒▒█▒▒▒▓▒▒▒▒▒░░    ██▒▒██▒    
                     ░░░░░▒▒▒▒▒▒███▒██████████▒▒█████▓▓▒▒▒▒▒▒░░░░░░░░░░░░░░░ ░░░░░░░░░░░░░▒▒▒▒▒▒▓█▒▒▓▒▒▒▒▒▓▒▒░    ▓▓▓█▓█▌    
                     ░░░░░▒▒▒▒▒▒▒██▓▒█████████▒▒▒▒█████▓▓▓▓▒▒▒▒▒░░░░░░░░░░░░░░░░░░░░░░░▒▒▒▒▒▓▓▓██▓█▒▒▒▒▓██▒▓▒▒▒░  ██████▌    
                      ░░▒▒▒▒██▒▒▒▒▓███████████▓▒▒▒▒▒▒██████████▓▓▒▒▒▒▒▒░░▒▒▒░░▒▒▒▒▒░▒▒▒▒▒▓▓████▓▓▓▓▓▓███▒█▒▒▒▒▒▒  ▓████▒▌    
                       ░▒▒▒▒▒▒█▒▒▓████████████▒▒▒▒▒▒▒▒▒████████████▓▒▒▒▒▒▒▒▒▒▒▒▒▒▒▒▓▓▓▓█████████████████▒█▒▒▒▒▒▒░ ██████▌    
                      ░▒▒▒▒▒▒▒▒▒███████████████▒▒▒▒▒▒▒▒████████████████▓▓█▓▓██▓████████████████████████▒▒▒█▓▒▒▒▒▒▒▒█████▌    
                    ░░▒▒▒▒▒▒▒▒▒▒▒▒▒▒████████▒██▒▒▒▒▒▒▒▒▒▒███████████████████████████████▒███████████▒▒▒▒▒▒█▒▒▒▒▒░▒▒█████▌    
                ░░▒▒▒▒▒▒▒▒▒▒▒▒▒▒▓▓▓██████████▒▒▒▒▒▒▒▒▒▒▒▒▒▒▒▒█▒████████▒▒▒▒▒██████▒▒▒▒▒▒████████████▓▒▒▒▒▒▒▒▒▒▒▒▒░▒▒████▌    
          ░░░░░░░░▒▒▒▒▒▒▒▒▒▒▒▒▒▒███████████████▒▒▒▒▒▒▒▒▒▒▒▒▒▒▒▒▒██▒▒█▒▒▒▒▒▒▒▒▒▒▒█▒▒▒▒▒▒▒██▒████████████▒▒██▒▒▒▒▒▒░▒█████▌    
        ░▒▒▒▒▒▒▒▒▒▒▒▒░░▒▒▒░▒▒░▒▒▒▓██████████▒███▒▒▒▒▒▒▒▒▒▒▒▒▒▒▒▒▒▒▒▒▒▒▒▒▒▒▒▒▒▒▒▒▒▒▒▒▒▒▒▒▒▒▒██████████▒██▓█▒▒▒▒▒▒▒░██████▓▄▄▓▓
         ▒▒▒▒▒▒▒▒▒▒▒▒▒▒░░░░▒▒▒▒▒▓████████▒█▒▓███▒▒▒▒▒▒▒▒▒▒▒▒▒▒▒▒▒▒▒▒██▒▒▒▒▒▒█▒▒▒▒▒▒▒▒▒▒▒▒▒▒█████████▒▒▓███▒▒▒▒▒▒▒░██████▌    
          ▒▓▒▒▒▒▒▒▒▒▒░░▒░▒▒▒▒▓▓█████████▓█▒█████▒▒▒▒▒▒▒▒▒▒▒▒▒▒▒▒▒▒▒██▒▒▒▒▒███▒▒▒▒▒▒▒▒▒▒▒▒▒▒██▒▒█████████▒▒▒▒▒▒▒▒░░██████▌    
            ░▒▒▒▒▒▒▒▒▒▒▓▓▓▓██████▓▓▓▓██▒▒▓████▒▒▒▒▒▒▒▒▒▒▒▒▒▒▒▒▒▒▒▒▒▒▒▒▒▒▒▒▒██▒▒▒▒▒▒▒▒▒▒▒▒▒▒███████████▒▒▓▓█▓▓▓▓▓▄▄██████▌    
            ░░░░▒▒███████████████████▓███████▒▒▒▒▒▒▒░▒▒▒▒▒▒▒▒▒▒▒▒▒▒▒▒▒▒▒▒▒▒▒▒▒▒▒▒▒▒▒▒▒▒▒▒▒▒▒▒▒█▒▒▒▒▒▒▒▒▒▒▒▒▒▒▒██████████▌    
        ░░▄▄▓▓▓████████████████████████████▒▒▒▒▒▒▒▒▒░░░░▒▒▒▒▒▒▒▒▒▒▒▒▒▒▒▒▒▒▒▒▒▒▒▒▒▒▒▒▒▒▒▒▒▒▒▒▒▒▒▒▒▒▒▒▒▒▒▒▒▒▒░░███████████▄    
    ▄▄▓▓█████████████████████████████████▓▓▓▓▒▒▒▒▒▒░░░░░░▒▒▒▒▒▒▒▒▒▒▒▒▒▒▒▒▒▒▒▒▒▒▒▒▒▒▒▒▒▒▒▒▒▒▒▒▒░░░░░░░░░░░▄▓███████████████▓▓▄
▓▓████████████████████████████████████████████▓▓▓▓▓▓▓▄░░▄▄▄▄░▒▒▒▒▒▒▒▒▒▒▒▒▒▒▒▒▒▒▒▒▒▒▒▒▒▒▒▒▒▒▒▒░░░░░░░▄▓▓▓▓████████▓█▓▓████████
███████████████████████████████████████████████████████████████▓▓▓██▓▓▓▄▒▒▒▒▒▒▒▒▒▒▒▒▒▒▒▒▒▒▒░░░░░░▄▄▓██████████████▓██████████
██████████████████████████████████████████████████████████████████████████▓██████▓▓▄▄▓▓▓▓░░▄▓███████████████▓████████████████
████████████████████████████████████████████▓▓███████████████▒▒██████████████████████████████████████▒██████▓████████████████
███████████████████████████████████████████████████████████████▒▒███████▒▒██████████████████████████▀██▓▓████████████████████
██████████████████████████████████████████████████████████████████████▒████▒███████████████▓▓█▀████▓█████████████████████████
