

                                ▐██▓▄   
                                   ▀██  
                                    ██▌ 
    ▐▄█                             ██▌ 
  ▄█████▄                           ██▌ 
▓█████████▄                        ▓██  
 ▀██████████▌▄                  ▄▄▓██   
    ▀███████████████████████████████▌   
     ▀███████████████████████████████   
      ███████████████████████████████▌  
       ██████████████████████████████▌  
        █████████████████████████████▓  
        ▐████████        █████████████▄ 
        ▓███ ▐███        ▐████   ▀█████▄
        ███   ▀██         ████      ▀███
       ▐██     ▐██▀      ▓██▀        ███
     ▄██▀        ██   ▀██▀          ███ 

