                                                                                                                                       
                            ,--.                            ,--.                                 ,--.                                  
 ,---.  ,--,--,       ,---. |  |  ,---.   ,---.   ,---.   ,-|  |      ,---.  ,--. ,--.  ,---.  ,-'  '-.  ,---.  ,--,--,--.  ,---.      
| .-. | |      \     | .--' |  | | .-. | (  .-'  | .-. : ' .-. |     (  .-'   \  '  /  (  .-'  '-.  .-' | .-. : |        | (  .-'      
' '-' ' |  ||  |     \ `--. |  | ' '-' ' .-'  `) \   --. \ `-' |     .-'  `)   \   '   .-'  `)   |  |   \   --. |  |  |  | .-'  `)     
 `---'  `--''--'      `---' `--'  `---'  `----'   `----'  `---'      `----'  .-'  /    `----'    `--'    `----' `--`--`--' `----'      
,--.                                 ,--.                            ,--.    `---'                        ,--.                         
`--'  ,---.       ,--,--.      ,---. |  |  ,---.   ,---.   ,---.   ,-|  |      ,---.  ,--. ,--.  ,---.  ,-'  '-.  ,---.  ,--,--,--.    
,--. (  .-'      ' ,-.  |     | .--' |  | | .-. | (  .-'  | .-. : ' .-. |     (  .-'   \  '  /  (  .-'  '-.  .-' | .-. : |        |    
|  | .-'  `)     \ '-'  |     \ `--. |  | ' '-' ' .-'  `) \   --. \ `-' |     .-'  `)   \   '   .-'  `)   |  |   \   --. |  |  |  |    
`--' `----'       `--`--'      `---' `--'  `---'  `----'   `----'  `---'      `----'  .-'  /    `----'    `--'    `----' `--`--`--'    
                                                                                      `---'                                          
