,------.                              ,--.                           ,--.     ,--.                                                            
|  .---'  ,---.  ,--.,--. ,--,--,   ,-|  |     ,--,--,--.  ,--,--. ,-'  '-. ,-'  '-.  ,---.  ,--.--.                                          
|  `--,  | .-. | |  ||  | |      \ ' .-. |     |        | ' ,-.  | '-.  .-' '-.  .-' | .-. : |  .--'                                          
|  |`    ' '-' ' '  ''  ' |  ||  | \ `-' |     |  |  |  | \ '-'  |   |  |     |  |   \   --. |  |                                             
`--'      `---'   `----'  `--''--'  `---'      `--`--`--'  `--`--'   `--'     `--'    `----' `--'                                             
,--.                                 ,--.                       ,--.   ,--.                             ,--.    ,--.    ,--. ,--.             
`--' ,--,--,  ,--.  ,--.  ,--,--.  ,-|  |  ,---.   ,---.      ,-'  '-. |  ,---.   ,---.      ,--,--,--. `--'  ,-|  |  ,-|  | |  |  ,---.      
,--. |      \  \  `'  /  ' ,-.  | ' .-. | | .-. : (  .-'      '-.  .-' |  .-.  | | .-. :     |        | ,--. ' .-. | ' .-. | |  | | .-. :     
|  | |  ||  |   \    /   \ '-'  | \ `-' | \   --. .-'  `)       |  |   |  | |  | \   --.     |  |  |  | |  | \ `-' | \ `-' | |  | \   --.     
`--' `--''--'    `--'     `--`--'  `---'   `----' `----'        `--'   `--' `--'  `----'     `--`--`--' `--'  `---'   `---'  `--'  `----'     
   ,--. ,--.           ,--.                                                                                                                   
 ,-|  | `--'  ,---.  ,-'  '-.  ,--,--. ,--,--,   ,---.  ,---.                                                                                 
' .-. | ,--. (  .-'  '-.  .-' ' ,-.  | |      \ | .--' | .-. :                                                                                
\ `-' | |  | .-'  `)   |  |   \ '-'  | |  ||  | \ `--. \   --. .--.                                                                           
 `---'  `--' `----'    `--'    `--`--' `--''--'  `---'  `----' '--'   
