                                                       ,--.   ,--.                        ,--.                             
 ,---.   ,---.  ,--.--.  ,---.   ,---.   ,---.   ,---. ,-'  '-. `--' ,--.  ,--.  ,---.      `--'  ,---.                      
| .-. | | .-. : |  .--' (  .-'  | .-. | | .-. : | .--' '-.  .-' ,--.  \  `'  /  | .-. :     ,--. (  .-'                      
| '-' ' \   --. |  |    .-'  `) | '-' ' \   --. \ `--.   |  |   |  |   \    /   \   --.     |  | .-'  `)                     
|  |-'   `----' `--'    `----'  |  |-'   `----'  `---'   `--'   `--'    `--'     `----'     `--' `----'                      
`--'                            `--'               ,--.                                                                      
 ,---.  ,--.--.  ,---.   ,---.   ,---.   ,---.   ,-|  |     ,--.,--.  ,---.                                                  
| .-. | |  .--' | .-. | | .-. | | .-. | | .-. : ' .-. |     |  ||  | | .-. |                                                 
| '-' ' |  |    ' '-' ' | '-' ' | '-' ' \   --. \ `-' |     '  ''  ' | '-' '                                                 
|  |-'  `--'     `---'  |  |-'  |  |-'   `----'  `---'       `----'  |  |-'                                                  
`--'                    `--'    `--'                                 `--'                                                    
                     ,--.       ,--.           ,--.                    ,--.                    ,--.                          
 ,--,--. ,--,--,   ,-|  |     ,-'  '-.  ,---.  |  |  ,---.  ,--.  ,--. `--'  ,---.   ,---.   ,-|  |                          
' ,-.  | |      \ ' .-. |     '-.  .-' | .-. : |  | | .-. :  \  `'  /  ,--. (  .-'  | .-. : ' .-. |                          
\ '-'  | |  ||  | \ `-' |       |  |   \   --. |  | \   --.   \    /   |  | .-'  `) \   --. \ `-' | .--.                     
 `--`--' `--''--'  `---'        `--'    `----' `--'  `----'    `--'    `--' `----'   `----'  `---'  '--'                     
  ,---.               ,--.  ,---.       ,--.   ,--.                                   ,--.            ,--.                   
 /  O  \   ,---.      `--' /  .-'     ,-'  '-. |  ,---.   ,---.       ,---.   ,--,--. `--' ,--,--,  ,-'  '-.  ,---.  ,--.--. 
|  .-.  | (  .-'      ,--. |  `-,     '-.  .-' |  .-.  | | .-. :     | .-. | ' ,-.  | ,--. |      \ '-.  .-' | .-. : |  .--' 
|  | |  | .-'  `)     |  | |  .-'       |  |   |  | |  | \   --.     | '-' ' \ '-'  | |  | |  ||  |   |  |   \   --. |  |    
`--' `--' `----'      `--' `--'         `--'   `--' `--'  `----'     |  |-'   `--`--' `--' `--''--'   `--'    `----' `--'    
                                                                     `--'                                                    