                                                                                                                                           
                                                                                                                                           
,--.   ,--.  ,---.  ,--.--.  ,---.       ,--,--. ,--,--,                                                                                   
|  |.'.|  | | .-. : |  .--' | .-. :     ' ,-.  | |      \                                                                                  
|   .'.   | \   --. |  |    \   --.     \ '-'  | |  ||  |                                                                                  
'--'   '--'  `----' `--'     `----'      `--`--' `--''--'                                                                                  
                ,--.         ,--.                                                                                         ,---.            
 ,---.   ,---.  `--'  ,---.  |  ,---.   ,---.  ,--,--,   ,---.  ,--,--,--.  ,---.  ,--,--,   ,---.  ,--,--,       ,---.  /  .-'            
| .-. : | .-. | ,--. | .-. | |  .-.  | | .-. : |      \ | .-. | |        | | .-. : |      \ | .-. | |      \     | .-. | |  `-,            
\   --. | '-' ' |  | | '-' ' |  | |  | \   --. |  ||  | ' '-' ' |  |  |  | \   --. |  ||  | ' '-' ' |  ||  |     ' '-' ' |  .-'            
 `----' |  |-'  `--' |  |-'  `--' `--'  `----' `--''--'  `---'  `--`--`--'  `----' `--''--'  `---'  `--''--'      `---'  `--'              
        `--'         `--' ,--.                                     ,------.                                                                
 ,---.   ,---.   ,---.  ,-'  '-. ,--.,--. ,--.--.  ,---.           |  .---'  ,---.  ,--.--.     ,--,--,--.  ,--,--. ,--,--,  ,--. ,--.     
| .-. | | .-. : (  .-'  '-.  .-' |  ||  | |  .--' | .-. :          |  `--,  | .-. | |  .--'     |        | ' ,-.  | |      \  \  '  /      
' '-' ' \   --. .-'  `)   |  |   '  ''  ' |  |    \   --. .--.     |  |`    ' '-' ' |  |        |  |  |  | \ '-'  | |  ||  |   \   '       
.`-  /   `----' `----'    `--'    `----'  `--'     `----' '--'     `--'      `---'  `--'        `--`--`--'  `--`--' `--''--' .-'  /        
`---'                                                                                                                        `---'         
,--. ,--.  ,---.   ,--,--. ,--.--.  ,---.                                                                                                  
 \  '  /  | .-. : ' ,-.  | |  .--' (  .-'                                                                                                  
  \   '   \   --. \ '-'  | |  |    .-'  `)                                                                                                 
.-'  /     `----'  `--`--' `--'    `----'   